NO textures_xpm/crafting_table_front.xpm
SO textures_xpm/dark_oak_log.xpm
WE textures_xpm/emerald_ore.xpm
EA textures_xpm/wool_colored_purple.xpm

F 120,90,77
C 42,13,25

11111
10001
10N01
10001
11111