NO textures_xpm/acacia_log.xpm
SO textures_xpm/acacia_log.xpm
WE textures_xpm/acacia_log.xpm
EA textures_xpm/acacia_log.xpm

F 255,0,0
C 0,0,255

        1111111111111111111111111
        1000000000110000000000001
        1011000001110000000000001
        1001000000000000000000001
111111111011000001110000000000001
100000000011000001110111111011111
11110111111111011100000011001
11110111111111011101010010001
11000000110101011100000010011
100000000000000011000000100111
1000000000000000110101001000101
11000001110101011111011110N0001
11110111 1110101 1011111000011
11111111 1111111 111111110111
                       1111
