NO textures_xpm/crafting_table_front.xpm
SO textures_xpm/dark_oak_log.xpm
WE textures_xpm/spruce_planks.xpm
EA textures_xpm/furnace_top.xpm

F 120,90,77
C 42,13,25

        1111111111111111111111111
        1000000000000000000000001
        1000000000000000000000001
        1000000000000000000000001
1111111110000011000001100000000S01
1000000000000111000001110000111P11
111101111000000011110000000111001
1111011110000001111110000000P0001
11000000100000011111100000011111
1P0000000000000111111000000111
1000000000000001111110000000101
1000000000000000111100000000101
1000000000000000000000000000101
1000000000000000000000000000101
1000000000000000000000000000101
1100000111010101111101111000001
11110111 1110101 1011111000011
11111111 1111111 111111110111
                       1111
